MMMMMMMMMMMMMMMMMMMMMMMMMMMMMMMMMMMMMMMMMMMMMMMMMMMMMMMMMMMMMMMMMMMMMMMMMMMMMMMMMMMMMMMMMMMMMMMMMMMMMMMMMMMMMMMMMMM
M-----------------------------------------------------------------------------------------------------------------M
M-----------------------------------------------------------------------------------------------------------------M
M-----------------------------------------------------------------------------------------------U---U---U---------M
M-----------------------------------------------------------------------------------------------U---U---U---------M
M------SSSS---SSSS---SSSS---SSSS---SSSS---SSSS---SSSS---SSSS---SSSS---SSSS---SSSS---SSSS--------U---U---U---------M
M------SSSS---SSSS---SSSS---SSSS---SSSS---SSSS---SSSS---SSSS---SSSS---SSSS---SSSS---SSSS--------U---U---U---------M
M------SSSS---SSSS---SSSS---SSSS---SSSS---SSSS---SSSS---SSSS---SSSS---SSSS---SSSS---SSSS--------U---U---U---------M
M------SSSS---SSSS---SSSS---SSSS---SSSS---SSSS---SSSS---SSSS---SSSS---SSSS---SSSS---SSSS--------O---O---O---------M
M------SSSS---SSSS---SSSS---SSSS---SSSS---SSSS---SSSS---SSSS---SSSS---SSSS---SSSS---SSSS--------------------------M
M------SSSS---SSSS---SSSS---SSSS---SSSS---SSSS---SSSS---SSSS---SSSS---SSSS---SSSS---SSSS--------------------------M
M------SSSS---SSSS---SSSS---SSSS---SSSS---SSSS---SSSS---SSSS---SSSS---SSSS---SSSS---SSSS--------------------------M
M------SSSS---SSSS---SSSS---SSSS---SSSS---SSSS---SSSS---SSSS---SSSS---SSSS---SSSS---SSSS--------------------------M
M------SSSS---SSSS---SSSS---SSSS---SSSS---SSSS---SSSS---SSSS---SSSS---SSSS---SSSS---SSSS--------------------------M
M------SSSS---SSSS---SSSS---SSSS---SSSS---SSSS---SSSS---SSSS---SSSS---SSSS---SSSS---SSSS--------------------------M
M------SSSS---SSSS---SSSS---SSSS---SSSS---SSSS---SSSS---SSSS---SSSS---SSSS---SSSS---SSSS--------------------------M
M------SSSS---SSSS---SSSS---SSSS---SSSS---SSSS---SSSS---SSSS---SSSS---SSSS---SSSS---SSSS--------------------------M
M------SSSS---SSSS---SSSS---SSSS---SSSS---SSSS---SSSS---SSSS---SSSS---SSSS---SSSS---SSSS--------------------------M
M------SSSS---SSSS---SSSS---SSSS---SSSS---SSSS---SSSS---SSSS---SSSS---SSSS---SSSS---SSSS--------------------------M
M------SSSS---SSSS---SSSS---SSSS---SSSS---SSSS---SSSS---SSSS---SSSS---SSSS---SSSS---SSSS---SSSS---SSSS---SSSS---SSM
M------SSSS---SSSS---SSSS---SSSS---SSSS---SSSS---SSSS---SSSS---SSSS---SSSS---SSSS---SSSS---SSSS---SSSS---SSSS---SSM
M------SSSS---SSSS---SSSS---SSSS---SSSS---SSSS---SSSS---SSSS---SSSS---SSSS---SSSS---SSSS---SSSS---SSSS---SSSS---SSM
M------SSSS---SSSS---SSSS---SSSS---SSSS---SSSS---SSSS---SSSS---SSSS---SSSS---SSSS---SSSS---SSSS---SSSS---SSSS---SSM
M------SSSS---SSSS---SSSS---SSSS---SSSS---SSSS---SSSS---SSSS---SSSS---SSSS---SSSS---SSSS---SSSS---SSSS---SSSS---SSM
M------SSSS---SSSS---SSSS---SSSS---SSSS---SSSS---SSSS---SSSS---SSSS---SSSS---SSSS---SSSS---SSSS---SSSS---SSSS---SSM
M------SSSS---SSSS---SSSS---SSSS---SSSS---SSSS---SSSS---SSSS---SSSS---SSSS---SSSS---SSSS---SSSS---SSSS---SSSS---SSM
M------SSSS---SSSS---SSSS---SSSS---SSSS---SSSS---SSSS---SSSS---SSSS---SSSS---SSSS---SSSS---SSSS---SSSS---SSSS---SSM
M------SSSS---SSSS---SSSS---SSSS---SSSS---SSSS---SSSS---SSSS---SSSS---SSSS---SSSS---SSSS---SSSS---SSSS---SSSS---SSM
M------SSSS---SSSS---SSSS---SSSS---SSSS---SSSS---SSSS---SSSS---SSSS---SSSS---SSSS---SSSS---SSSS---SSSS---SSSS---SSM
M------SSSS---SSSS---SSSS---SSSS---SSSS---SSSS---SSSS---SSSS---SSSS---SSSS---SSSS---SSSS---SSSS---SSSS---SSSS---SSM
M------SSSS---SSSS---SSSS---SSSS---SSSS---SSSS---SSSS---SSSS---SSSS---SSSS---SSSS---SSSS---SSSS---SSSS---SSSS---SSM
M------SSSS---SSSS---SSSS---SSSS---SSSS---SSSS---SSSS---SSSS---SSSS---SSSS---SSSS---SSSS---SSSS---SSSS---SSSS---SSM
M------SSSS---SSSS---SSSS---SSSS---SSSS---SSSS---SSSS---SSSS---SSSS---SSSS---SSSS---SSSS---SSSS---SSSS---SSSS---SSM
M---------------------------------------------------------------------------------------------------------------SSM
M---------------------------------------------------------------------------------------------------------------SSM
M---------------------------------------------------------------------------------------------------------------SSM
M---------------------------------------------------------------------------------------------------------------SSM
M---------------------------------------------------------------------------------------------------------------SSM
M---------------------------------------------------------------------------------------------------------------SSM
M------SSSS---SSSS---SSSS---SSSS---SSSS---SSSS---SSSS---SSSS---SSSS---SSSS---SSSS---SSSS---SSSS---SSSS---SSSS---SSM
M------SSSS---SSSS---SSSS---SSSS---SSSS---SSSS---SSSS---SSSS---SSSS---SSSS---SSSS---SSSS---SSSS---SSSS---SSSS---SSM
M------SSSS---SSSS---SSSS---SSSS---SSSS---SSSS---SSSS---SSSS---SSSS---SSSS---SSSS---SSSS---SSSS---SSSS---SSSS---SSM
M------SSSS---SSSS---SSSS---SSSS---SSSS---SSSS---SSSS---SSSS---SSSS---SSSS---SSSS---SSSS---SSSS---SSSS---SSSS---SSM
M------SSSS---SSSS---SSSS---SSSS---SSSS---SSSS---SSSS---SSSS---SSSS---SSSS---SSSS---SSSS---SSSS---SSSS---SSSS---SSM
M------SSSS---SSSS---SSSS---SSSS---SSSS---SSSS---SSSS---SSSS---SSSS---SSSS---SSSS---SSSS---SSSS---SSSS---SSSS---SSM
M------SSSS---SSSS---SSSS---SSSS---SSSS---SSSS---SSSS---SSSS---SSSS---SSSS---SSSS---SSSS---SSSS---SSSS---SSSS---SSM
M------SSSS---SSSS---SSSS---SSSS---SSSS---SSSS---SSSS---SSSS---SSSS---SSSS---SSSS---SSSS---SSSS---SSSS---SSSS---SSM
M------SSSS---SSSS---SSSS---SSSS---SSSS---SSSS---SSSS---SSSS---SSSS---SSSS---SSSS---SSSS---SSSS---SSSS---SSSS---SSM
M------SSSS---SSSS---SSSS---SSSS---SSSS---SSSS---SSSS---SSSS---SSSS---SSSS---SSSS---SSSS---SSSS---SSSS---SSSS---SSM
M------SSSS---SSSS---SSSS---SSSS---SSSS---SSSS---SSSS---SSSS---SSSS---SSSS---SSSS---SSSS---SSSS---SSSS---SSSS---SSM
M------SSSS---SSSS---SSSS---SSSS---SSSS---SSSS---SSSS---SSSS---SSSS---SSSS---SSSS---SSSS---SSSS---SSSS---SSSS---SSM
M------SSSS---SSSS---SSSS---SSSS---SSSS---SSSS---SSSS---SSSS---SSSS---SSSS---SSSS---SSSS---SSSS---SSSS---SSSS---SSM
M------SSSS---SSSS---SSSS---SSSS---SSSS---SSSS---SSSS---SSSS---SSSS---SSSS---SSSS---SSSS---SSSS---SSSS---SSSS---SSM
M------SSSS---SSSS---SSSS---SSSS---SSSS---SSSS---SSSS---SSSS---SSSS---SSSS---SSSS---SSSS---SSSS---SSSS---SSSS---SSM
M------SSSS---SSSS---SSSS---SSSS---SSSS---SSSS---SSSS---SSSS---SSSS---SSSS---SSSS---SSSS---SSSS---SSSS---SSSS---SSM
M------SSSS---SSSS---SSSS---SSSS---SSSS---SSSS---SSSS---SSSS---SSSS---SSSS---SSSS---SSSS---SSSS---SSSS---SSSS---SSM
M------SSSS---SSSS---SSSS---SSSS---SSSS---SSSS---SSSS---SSSS---SSSS---SSSS---SSSS---SSSS---SSSS---SSSS---SSSS---SSM
M------SSSS---SSSS---SSSS---SSSS---SSSS---SSSS---SSSS---SSSS---SSSS---SSSS---SSSS---SSSS---SSSS---SSSS---SSSS---SSM
M------SSSS---SSSS---SSSS---SSSS---SSSS---SSSS---SSSS---SSSS---SSSS---SSSS---SSSS---SSSS---SSSS---SSSS---SSSS---SSM
M------SSSS---SSSS---SSSS---SSSS---SSSS---SSSS---SSSS---SSSS---SSSS---SSSS---SSSS---SSSS---SSSS---SSSS---SSSS---SSM
M------SSSS---SSSS---SSSS---SSSS---SSSS---SSSS---SSSS---SSSS---SSSS---SSSS---SSSS---SSSS---SSSS---SSSS---SSSS---SSM
M---------------------------------------------------------------------------------------------------------------SSM
M---------------------------------------------------------------------------------------------------------------SSM
M---------------------------------------------------------------------------------------------------------------SSM
M---------------------------------------------------------------------------------------------------------------SSM
M---------------------------------------------------------------------------------------------------------------SSM
M---------------------------------------------------------------------------------------------------------------SSM
M---------------------------SSSS---SSSS---SSSS---SSSS---SSSS---SSSS---SSSS---SSSS---SSSS---SSSS---SSSS---SSSS---SSM
M---------------------------SSSS---SSSS---SSSS---SSSS---SSSS---SSSS---SSSS---SSSS---SSSS---SSSS---SSSS---SSSS---SSM
M---------------------------SSSS---SSSS---SSSS---SSSS---SSSS---SSSS---SSSS---SSSS---SSSS---SSSS---SSSS---SSSS---SSM
M---------------------------SSSS---SSSS---SSSS---SSSS---SSSS---SSSS---SSSS---SSSS---SSSS---SSSS---SSSS---SSSS---SSM
M---------------------------SSSS---SSSS---SSSS---SSSS---SSSS---SSSS---SSSS---SSSS---SSSS---SSSS---SSSS---SSSS---SSM
M---------------------------SSSS---SSSS---SSSS---SSSS---SSSS---SSSS---SSSS---SSSS---SSSS---SSSS---SSSS---SSSS---SSM
M---------------------------SSSS---SSSS---SSSS---SSSS---SSSS---SSSS---SSSS---SSSS---SSSS---SSSS---SSSS---SSSS---SSM
M---------------------------SSSS---SSSS---SSSS---SSSS---SSSS---SSSS---SSSS---SSSS---SSSS---SSSS---SSSS---SSSS---SSM
M---------------------------SSSS---SSSS---SSSS---SSSS---SSSS---SSSS---SSSS---SSSS---SSSS---SSSS---SSSS---SSSS---SSM
M---------------------------SSSS---SSSS---SSSS---SSSS---SSSS---SSSS---SSSS---SSSS---SSSS---SSSS---SSSS---SSSS---SSM
M---------------------------SSSS---SSSS---SSSS---SSSS---SSSS---SSSS---SSSS---SSSS---SSSS---SSSS---SSSS---SSSS---SSM
M---------------------------SSSS---SSSS---SSSS---SSSS---SSSS---SSSS---SSSS---SSSS---SSSS---SSSS---SSSS---SSSS---SSM
M--------JJJJ---------------SSSS---SSSS---SSSS---SSSS---SSSS---SSSS---SSSS---SSSS---SSSS---SSSS---SSSS---SSSS---SSM
M-------JJJJJJI-------------SSSS---SSSS---SSSS---SSSS---SSSS---SSSS---SSSS---SSSS---SSSS---SSSS---SSSS---SSSS---SSM
M------JJJJJJ---------------SSSS---SSSS---SSSS---SSSS---SSSS---SSSS---SSSS---SSSS---SSSS---SSSS---SSSS---SSSS---SSM
MJJJJJJJJJJJJJ--------------SSSS---SSSS---SSSS---SSSS---SSSS---SSSS---SSSS---SSSS---SSSS---SSSS---SSSS---SSSS---SSM
M------JJJJJJ---------------SSSS---SSSS---SSSS---SSSS---SSSS---SSSS---SSSS---SSSS---SSSS---SSSS---SSSS---SSSS---SSM
M---------------------------SSSS---SSSS---SSSS---SSSS---SSSS---SSSS---SSSS---SSSS---SSSS---SSSS---SSSS---SSSS---SSM
M---------------------------SSSS---SSSS---SSSS---SSSS---SSSS---SSSS---SSSS---SSSS---SSSS---SSSS---SSSS---SSSS---SSM
M---------------------------SSSS---SSSS---SSSS---SSSS---SSSS---SSSS---SSSS---SSSS---SSSS---SSSS---SSSS---SSSS---SSM
M-----------------------------------------------------------------------------------------------------------------M
M-----------------------------------------------------------------------------------------------------------------M
MMMMMMMMMMMMMMMMMMMMMMMMMMMMMMMMMMMMMMMMMMMMMMMMMMMMMMMMMMMMMMMMMMMMMMMMMMMMMMMMMMMMMMMMMMMMMMMMMMMMMMMMMMMMMMMMMMM