MMMMMMMMMMMMMMMMMMMMMMMMMMMMMMMMMMMMMMMMMMMMMMMMMMMMMMMMMMMMMMMMMMMMMMMMMMMMMMMMMMMMMMMMMMMMMMMMMMMMMMMMMMMMMMMMMMM
M-----------------------------------------------------------------------------------------------------------------M
M-----------------------------------------------------------------------------------------------------------------M
M-----------------------------------------------------------------------------------------------O---O---O---------M
M-----------------------------------------------------------------------------------------------O---O---O---------M
M------SSSS---SSSS---SSSS---SSSS---SSSS---SSSS---SSSS---SSSS---SSSS---SSSS---SSSS---SSSS--------O---O---O---------M
M------SSSS---SSSS---SSSS---SSSS---SSSS---SSSS---SSSS---SSSS---SSSS---SSSS---SSSS---SSSS--------O---O---O---------M
M------SSSS---SSSS---SSSS---SSSS---SSSS---SSSS---SSSS---SSSS---SSSS---SSSS---SSSS---SSSS--------O---O---O---------M
M------SSSS---SSSS---SSSS---SSSS---SSSS---SSSS---SSSS---SSSS---SSSS---SSSS---SSSS---SSSS--------O---O---O---------M
M------SSSS---SSSS---SSSS---SSSS---SSSS---SSSS---SSSS---SSSS---SSSS---SSSS---SSSS---SSSS--------------------------M
M------SSSS---SSSS---SSSS---SSSS---SSSS---SSSS---SSSS---SSSS---SSSS---SSSS---SSSS---SSSS--------------------------M
M------SSSS---SSSS---SSSS---SSSS---SSSS---SSSS---SSSS---SSSS---SSSS---SSSS---SSSS---SSSS--------------------------M
M------SSSS---SSSS---SSSS---SSSS---SSSS---SSSS---SSSS---SSSS---SSSS---SSSS---SSSS---SSSS--------------------------M
M------SSSS---SSSS---SSSS---SSSS---SSSS---SSSS---SSSS---SSSS---SSSS---SSSS---SSSS---SSSS--------------------------M
M------SSSS---SSSS---SSSS---SSSS---SSSS---SSSS---SSSS---SSSS---SSSS---SSSS---SSSS---SSSS--------------------------M
M------SSSS---SSSS---SSSS---SSSS---SSSS---SSSS---SSSS---SSSS---SSSS---SSSS---SSSS---SSSS--------------------------M
M------SSSS---SSSS---SSSS---SSSS---SSSS---SSSS---SSSS---SSSS---SSSS---SSSS---SSSS---SSSS--------------------------M
M------SSSS---SSSS---SSSS---SSSS---SSSS---SSSS---SSSS---SSSS---SSSS---SSSS---SSSS---SSSS--------------------------M
M------SSSS---SSSS---SSSS---SSSS---SSSS---SSSS---SSSS---SSSS---SSSS---SSSS---SSSS---SSSS--------------------------M
M------SSSS---SSSS---SSSS---SSSS---SSSS---SSSS---SSSS---SSSS---SSSS---SSSS---SSSS---SSSS---SSSS---SSSS---SSSS---SSM
M------SSSS---SSSS---SSSS---SSSS---SSSS---SSSS---SSSS---SSSS---SSSS---SSSS---SSSS---SSSS---SSSS---SSSS---SSSS---SSM
M------SSSS---SSSS---SSSS---SSSS---SSSS---SSSS---SSSS---SSSS---SSSS---SSSS---SSSS---SSSS---SSSS---SSSS---SSSS---SSM
M------SSSS---SSSS---SSSS---SSSS---SSSS---SSSS---SSSS---SSSS---SSSS---SSSS---SSSS---SSSS---SSSS---SSSS---SSSS---SSM
M------SSSS---SSSS---SSSS---SSSS---SSSS---SSSS---SSSS---SSSS---SSSS---SSSS---SSSS---SSSS---SSSS---SSSS---SSSS---SSM
M------SSSS---SSSS---SSSS---SSSS---SSSS---SSSS---SSSS---SSSS---SSSS---SSSS---SSSS---SSSS---SSSS---SSSS---SSSS---SSM
M------SSSS---SSSS---SSSS---SSSS---SSSS---SSSS---SSSS---SSSS---SSSS---SSSS---SSSS---SSSS---SSSS---SSSS---SSSS---SSM
M------SSSS---SSSS---SSSS---SSSS---SSSS---SSSS---SSSS---SSSS---SSSS---SSSS---SSSS---SSSS---SSSS---SSSS---SSSS---SSM
M------SSSS---SSSS---SSSS---SSSS---SSSS---SSSS---SSSS---SSSS---SSSS---SSSS---SSSS---SSSS---SSSS---SSSS---SSSS---SSM
M------SSSS---SSSS---SSSS---SSSS---SSSS---SSSS---SSSS---SSSS---SSSS---SSSS---SSSS---SSSS---SSSS---SSSS---SSSS---SSM
M------SSSS---SSSS---SSSS---SSSS---SSSS---SSSS---SSSS---SSSS---SSSS---SSSS---SSSS---SSSS---SSSS---SSSS---SSSS---SSM
M------SSSS---SSSS---SSSS---SSSS---SSSS---SSSS---SSSS---SSSS---SSSS---SSSS---SSSS---SSSS---SSSS---SSSS---SSSS---SSM
M------SSSS---SSSS---SSSS---SSSS---SSSS---SSSS---SSSS---SSSS---SSSS---SSSS---SSSS---SSSS---SSSS---SSSS---SSSS---SSM
M------SSSS---SSSS---SSSS---SSSS---SSSS---SSSS---SSSS---SSSS---SSSS---SSSS---SSSS---SSSS---SSSS---SSSS---SSSS---SSM
M---------------------------------------------------------------------------------------------------------------SSM
M---------------------------------------------------------------------------------------------------------------SSM
M------------------1----2----3----------------------------------------------------------------------------------SSM
M---------------------------------------------------------------------------------------------------------------SSM
M---------------------------------------------------------------------------------------------------------------SSM
M---------------------------------------------------------------------------------------------------------------SSM
M------SSSS---SSSS---SSSS---SSSS---SSSS---SSSS---SSSS---SSSS---SSSS---SSSS---SSSS---SSSS---SSSS---SSSS---SSSS---SSM
M------SSSS---SSSS---SSSS---SSSS---SSSS---SSSS---SSSS---SSSS---SSSS---SSSS---SSSS---SSSS---SSSS---SSSS---SSSS---SSM
M------SSSS---SSSS---SSSS---SSSS---SSSS---SSSS---SSSS---SSSS---SSSS---SSSS---SSSS---SSSS---SSSS---SSSS---SSSS---SSM
M------SSSS---SSSS---SSSS---SSSS---SSSS---SSSS---SSSS---SSSS---SSSS---SSSS---SSSS---SSSS---SSSS---SSSS---SSSS---SSM
M------SSSS---SSSS---SSSS---SSSS---SSSS---SSSS---SSSS---SSSS---SSSS---SSSS---SSSS---SSSS---SSSS---SSSS---SSSS---SSM
M------SSSS---SSSS---SSSS---SSSS---SSSS---SSSS---SSSS---SSSS---SSSS---SSSS---SSSS---SSSS---SSSS---SSSS---SSSS---SSM
M------SSSS---SSSS---SSSS---SSSS---SSSS---SSSS---SSSS---SSSS---SSSS---SSSS---SSSS---SSSS---SSSS---SSSS---SSSS---SSM
M------SSSS---SSSS---SSSS---SSSS---SSSS---SSSS---SSSS---SSSS---SSSS---SSSS---SSSS---SSSS---SSSS---SSSS---SSSS---SSM
M------SSSS---SSSS---SSSS---SSSS---SSSS---SSSS---SSSS---SSSS---SSSS---SSSS---SSSS---SSSS---SSSS---SSSS---SSSS---SSM
M------SSSS---SSSS---SSSS---SSSS---SSSS---SSSS---SSSS---SSSS---SSSS---SSSS---SSSS---SSSS---SSSS---SSSS---SSSS---SSM
M------SSSS---SSSS---SSSS---SSSS---SSSS---SSSS---SSSS---SSSS---SSSS---SSSS---SSSS---SSSS---SSSS---SSSS---SSSS---SSM
M------SSSS---SSSS---SSSS---SSSS---SSSS---SSSS---SSSS---SSSS---SSSS---SSSS---SSSS---SSSS---SSSS---SSSS---SSSS---SSM
M------SSSS---SSSS---SSSS---SSSS---SSSS---SSSS---SSSS---SSSS---SSSS---SSSS---SSSS---SSSS---SSSS---SSSS---SSSS---SSM
M------SSSS---SSSS---SSSS---SSSS---SSSS---SSSS---SSSS---SSSS---SSSS---SSSS---SSSS---SSSS---SSSS---SSSS---SSSS---SSM
M------SSSS---SSSS---SSSS---SSSS---SSSS---SSSS---SSSS---SSSS---SSSS---SSSS---SSSS---SSSS---SSSS---SSSS---SSSS---SSM
M------SSSS---SSSS---SSSS---SSSS---SSSS---SSSS---SSSS---SSSS---SSSS---SSSS---SSSS---SSSS---SSSS---SSSS---SSSS---SSM
M------SSSS---SSSS---SSSS---SSSS---SSSS---SSSS---SSSS---SSSS---SSSS---SSSS---SSSS---SSSS---SSSS---SSSS---SSSS---SSM
M------SSSS---SSSS---SSSS---SSSS---SSSS---SSSS---SSSS---SSSS---SSSS---SSSS---SSSS---SSSS---SSSS---SSSS---SSSS---SSM
M------SSSS---SSSS---SSSS---SSSS---SSSS---SSSS---SSSS---SSSS---SSSS---SSSS---SSSS---SSSS---SSSS---SSSS---SSSS---SSM
M------SSSS---SSSS---SSSS---SSSS---SSSS---SSSS---SSSS---SSSS---SSSS---SSSS---SSSS---SSSS---SSSS---SSSS---SSSS---SSM
M------SSSS---SSSS---SSSS---SSSS---SSSS---SSSS---SSSS---SSSS---SSSS---SSSS---SSSS---SSSS---SSSS---SSSS---SSSS---SSM
M------SSSS---SSSS---SSSS---SSSS---SSSS---SSSS---SSSS---SSSS---SSSS---SSSS---SSSS---SSSS---SSSS---SSSS---SSSS---SSM
M---------------------------------------------------------------------------------------------------------------SSM
M---------------------------------------------------------------------------------------------------------------SSM
M---------------------------------------------------------------------------------------------------------------SSM
M---------------------------------------------------------------------------------------------------------------SSM
M---------------------------------------------------------------------------------------------------------------SSM
M---------------------------------------------------------------------------------------------------------------SSM
M---------------------------SSSS---SSSS---SSSS---SSSS---SSSS---SSSS---SSSS---SSSS---SSSS---SSSS---SSSS---SSSS---SSM
M---------------------------SSSS---SSSS---SSSS---SSSS---SSSS---SSSS---SSSS---SSSS---SSSS---SSSS---SSSS---SSSS---SSM
M---------------------------SSSS---SSSS---SSSS---SSSS---SSSS---SSSS---SSSS---SSSS---SSSS---SSSS---SSSS---SSSS---SSM
M---------------------------SSSS---SSSS---SSSS---SSSS---SSSS---SSSS---SSSS---SSSS---SSSS---SSSS---SSSS---SSSS---SSM
M---------------------------SSSS---SSSS---SSSS---SSSS---SSSS---SSSS---SSSS---SSSS---SSSS---SSSS---SSSS---SSSS---SSM
M---------------------------SSSS---SSSS---SSSS---SSSS---SSSS---SSSS---SSSS---SSSS---SSSS---SSSS---SSSS---SSSS---SSM
M---------------------------SSSS---SSSS---SSSS---SSSS---SSSS---SSSS---SSSS---SSSS---SSSS---SSSS---SSSS---SSSS---SSM
M---------------------------SSSS---SSSS---SSSS---SSSS---SSSS---SSSS---SSSS---SSSS---SSSS---SSSS---SSSS---SSSS---SSM
M---------------------------SSSS---SSSS---SSSS---SSSS---SSSS---SSSS---SSSS---SSSS---SSSS---SSSS---SSSS---SSSS---SSM
M---------------------------SSSS---SSSS---SSSS---SSSS---SSSS---SSSS---SSSS---SSSS---SSSS---SSSS---SSSS---SSSS---SSM
M---------------------------SSSS---SSSS---SSSS---SSSS---SSSS---SSSS---SSSS---SSSS---SSSS---SSSS---SSSS---SSSS---SSM
M---------------------------SSSS---SSSS---SSSS---SSSS---SSSS---SSSS---SSSS---SSSS---SSSS---SSSS---SSSS---SSSS---SSM
M--------IIII---------------SSSS---SSSS---SSSS---SSSS---SSSS---SSSS---SSSS---SSSS---SSSS---SSSS---SSSS---SSSS---SSM
M-------IIIIIII-------------SSSS---SSSS---SSSS---SSSS---SSSS---SSSS---SSSS---SSSS---SSSS---SSSS---SSSS---SSSS---SSM
M------IIIIII---------------SSSS---SSSS---SSSS---SSSS---SSSS---SSSS---SSSS---SSSS---SSSS---SSSS---SSSS---SSSS---SSM
MIIIIIIIIIIIII--------------SSSS---SSSS---SSSS---SSSS---SSSS---SSSS---SSSS---SSSS---SSSS---SSSS---SSSS---SSSS---SSM
M------IIIIII---------------SSSS---SSSS---SSSS---SSSS---SSSS---SSSS---SSSS---SSSS---SSSS---SSSS---SSSS---SSSS---SSM
M---------------------------SSSS---SSSS---SSSS---SSSS---SSSS---SSSS---SSSS---SSSS---SSSS---SSSS---SSSS---SSSS---SSM
M---------------------------SSSS---SSSS---SSSS---SSSS---SSSS---SSSS---SSSS---SSSS---SSSS---SSSS---SSSS---SSSS---SSM
M---------------------------SSSS---SSSS---SSSS---SSSS---SSSS---SSSS---SSSS---SSSS---SSSS---SSSS---SSSS---SSSS---SSM
M-----------------------------------------------------------------------------------------------------------------M
M-----------------------------------------------------------------------------------------------------------------M
MMMMMMMMMMMMMMMMMMMMMMMMMMMMMMMMMMMMMMMMMMMMMMMMMMMMMMMMMMMMMMMMMMMMMMMMMMMMMMMMMMMMMMMMMMMMMMMMMMMMMMMMMMMMMMMMMMM